<?xml version="1.0" encoding="utf-8"?><!DOCTYPE SokobanLevels SYSTEM "SokobanLev.dtd"[]><SokobanLevels><Title>Cosmopoly</Title><Description>This set contains several variations of Cosmos levels, and some levels realised with other authors.</Description><Email>aymeric.du-peloux@gadz.org</Email><Url>http://membres.lycos.fr/nabokos/</Url><LevelCollection Copyright="Aymeric du Peloux" MaxWidth="12" MaxHeight="12"><Level Id="MINICOSMOS 28 var." Width="8" Height="9"><L> ####</L><L> #  ####</L><L> #     #</L><L>## #.  #</L><L># * #*##</L><L># $  * #</L><L># # @  #</L><L>#   ####</L><L>#####</L></Level><Level Id="MICROCOSMOS 31 var." Width="8" Height="9" Copyright="David Holland et Aymeric du Peloux"><L>  #####</L><L>###@  #</L><L># $*#$##</L><L># #  . #</L><L># . $# #</L><L>## #.  #</L><L> #    ##</L><L> ###  #</L><L>   ####</L></Level><Level Id="NABOKOSMOS 39 var." Width="8" Height="12"><L>  ####</L><L>  #  #</L><L>  #  #</L><L>### *###</L><L>#      #</L><L># .*** #</L><L>## $  ##</L><L> ##* ##</L><L>  #@  #</L><L>  # # #</L><L>  #   #</L><L>  #####</L></Level><Level Id="For ban 1" Width="8" Height="8" Copyright="François Marques et Aymeric du Peloux"><L>#####</L><L>#   ####</L><L>#  $$  #</L><L>##.@ . #</L><L> #. #.##</L><L> # $$ #</L><L> #  ###</L><L> ####</L></Level><Level Id="For ban 15" Width="9" Height="9" Copyright="François Marques et Aymeric du Peloux"><L>#####</L><L>#. .#####</L><L>#  .    #</L><L>##$$@$  #</L><L>## ######</L><L>#  $ ##</L><L>#   . #</L><L>###   #</L><L>  #####</L></Level><Level Id="Align that" Width="9" Height="7" Copyright="François Marques et Aymeric du Peloux"><L>  ####</L><L> ##  #</L><L> #   ####</L><L>##$ ..*.#</L><L># $  #$ #</L><L>#    #@ #</L><L>#########</L></Level><Level Id="NABOKOSMOS 18 var." Width="9" Height="9"><L>  #####</L><L> ##   #</L><L> #  # ###</L><L> # # *  #</L><L> # #  #@#</L><L> #   *  #</L><L> ### *$##</L><L>   # . #</L><L>   #####</L></Level><Level Id="MICROCOSMOS 26 var." Width="10" Height="10" Copyright="Howard Abed et Aymeric du Peloux"><L>  ########</L><L>  #   #  #</L><L>  # . $. #</L><L> ###$##  #</L><L> #.. ##$##</L><L>## $*$   #</L><L>#  * #   #</L><L>#  @.#####</L><L>##   #</L><L> #####</L></Level><Level Id="MICROCOSMOS 37 var." Width="12" Height="8" Copyright="Evgeny Grigoriev (GRIGoRusha) et Aymeric du Peloux"><L>       ####</L><L>######## @#</L><L>#  $ $ $ $#</L><L># #*.  .# ##</L><L>#    . #.  #</L><L>##$### .   #</L><L> #     #####</L><L> #######</L></Level><Level Id="MICROCOSMOS 18 var." Width="9" Height="8" Copyright="Masato Hiramatsu et Aymeric du Peloux"><L> #######</L><L> #  #  #</L><L> #$.@.$#</L><L> # .#. #</L><L>##$.#.$##</L><L># $   $ #</L><L>#   #   #</L><L>#########</L></Level><Level Id="NABOKOSMOS 32 var." Width="9" Height="9" Copyright="Evgeny Grigoriev (GRIGoRusha) et Aymeric du Peloux"><L>#####</L><L>#   ####</L><L>#  $.$ ##</L><L>##$#@#  #</L><L> # ...  #</L><L>##$#.# ##</L><L>#   $   #</L><L>#   #   #</L><L>#########</L></Level><Level Id="MICROCOSMOS 10 var." Width="7" Height="9"><L> #####</L><L>##  .#</L><L># $#.##</L><L>#     #</L><L>##$   #</L><L>#  #*##</L><L># @  #</L><L>#  ###</L><L>####</L></Level><Level Id="MICROCOSMOS 39 var." Width="8" Height="8"><L>  #####</L><L>###   ##</L><L># .. . #</L><L># $$ # #</L><L>## #$$ #</L><L> #.@  ##</L><L> ###  #</L><L>   ####</L></Level><Level Id="NABOKOSMOS 12 var." Width="9" Height="9"><L>  #####</L><L>###   #</L><L>#   #.##</L><L>#  *$@ #</L><L>## * **##</L><L> # # #  #</L><L> #      #</L><L> ###  ###</L><L>   ####</L></Level><Level Id="MINICOSMOS 30 var." Width="8" Height="10"><L>########</L><L>#   #  #</L><L>#      #</L><L>## #.$.#</L><L>#  $@###</L><L># #$*.#</L><L># # # #</L><L>#     #</L><L>##   ##</L><L> #####</L></Level><Level Id="PICOKOSMOS 02 var." Width="10" Height="8"><L>     #####</L><L>   ###   #</L><L>  ## * # #</L><L> ##      #</L><L>## * * ###</L><L>#   $###</L><L>#  + #</L><L>######</L></Level><Level Id="MICROCOSMOS 01 var.  " Width="9" Height="7"><L>#### ####</L><L>######  #</L><L>#@ $. $ #</L><L># $ .$  #</L><L>### . ###</L><L>  # . #</L><L>  #####</L></Level><Level Id="NABOKOSMOS 23 var.  " Width="9" Height="9"><L>   ####</L><L> ###  ##</L><L>## *   #</L><L>#  ##  ##</L><L>#@$*    #</L><L>## .# # #</L><L> # *    #</L><L> #  #####</L><L> ####</L></Level><Level Id="MICROCOSMOS 28 var." Width="10" Height="9"><L>      ####</L><L>     ## .#</L><L>    ##   #</L><L>   ## ...#</L><L>#### $$ ##</L><L># @$   ##</L><L>#  $  ##</L><L>#   ###</L><L>#####</L></Level><Level Id="MICROCOSMOS 21 var.  " Width="9" Height="9"><L>  #####</L><L>  #   ###</L><L>### # $ #</L><L># $* .# #</L><L># # +   #</L><L>#  *#.###</L><L>## $  #</L><L> #  ###</L><L> ####</L></Level><Level Id="MICROCOSMOS 25 var." Width="10" Height="8" Copyright="Brian Damgaard (with YASgen) et Aymeric du Peloux"><L>     ####</L><L>  ####@ #</L><L>  #.* $ #</L><L>###   # ##</L><L>#    #.. #</L><L>#    $ $ #</L><L>####  ####</L><L>   ####</L></Level><Level Id="PICOKOSMOS 20 var." Width="8" Height="10" Copyright="Evgeny Grigoriev (GRIGoRusha) et Aymeric du Peloux"><L>  ####</L><L> ##  #</L><L>## $ ###</L><L># $@*  #</L><L>#  * #.#</L><L>##* *  #</L><L> # . . #</L><L> # #$###</L><L> #   #</L><L> #####</L></Level></LevelCollection></SokobanLevels>