<?xml version="1.0" encoding="utf-8"?><!DOCTYPE SokobanLevels SYSTEM "SokobanLev.dtd"[]><SokobanLevels><Title>Cosmonotes</Title><Description></Description><Email>aymeric.du-peloux@gadz.org</Email><Url>http://membres.lycos.fr/nabokos/</Url><LevelCollection Copyright="Aymeric du Peloux" MaxWidth="11" MaxHeight="11"><Level Id="COSMONOTES 1" Width="9" Height="8"><L>########</L><L>#@  #  #</L><L># ..   ##</L><L>##.##   #</L><L> #  $$# #</L><L> ###$   #</L><L>   #  ###</L><L>   ####</L></Level><Level Id="COSMONOTES 2" Width="10" Height="11"><L> ####</L><L> #  ######</L><L> #       #</L><L>## ####  #</L><L>#@* ### ##</L><L>#  * ## #</L><L>##  * # ##</L><L> ## .$#  #</L><L>  ##     #</L><L>   ####  #</L><L>      ####</L></Level><Level Id="COSMONOTES 3" Width="10" Height="10"><L> #########</L><L> #       #</L><L> # ##### #</L><L> # #   # #</L><L> # $.#@# #</L><L>###$.  # #</L><L>#  $.### #</L><L># #$.    #</L><L>#    #####</L><L>######</L></Level><Level Id="COSMONOTES 4" Width="9" Height="10"><L> #####</L><L> #   ####</L><L> # #$$  #</L><L>## #@ # #</L><L>#  #$. .#</L><L>#  .$. ##</L><L>###  # ##</L><L>  ##    #</L><L>   ##   #</L><L>    #####</L></Level><Level Id="COSMONOTES 5" Width="11" Height="9"><L>      ####</L><L>#######  ##</L><L>#@$       #</L><L># *###  # #</L><L>##..    # #</L><L>##*#      #</L><L># $  ######</L><L>#   ##</L><L>#####</L></Level><Level Id="COSMONOTES 6" Width="11" Height="9"><L> ########</L><L> #  ##  #</L><L> #.$   .###</L><L> # .## $  #</L><L>##$### #  #</L><L># $    # ##</L><L># @ #.    #</L><L>#######   #</L><L>      #####</L></Level><Level Id="COSMONOTES 7" Width="9" Height="9"><L>  #####</L><L>  #   ###</L><L>  # #*  #</L><L> ##+*   #</L><L> #   # ##</L><L>##$#*#  #</L><L>#    *  #</L><L>#   ##  #</L><L>#########</L></Level><Level Id="COSMONOTES 8" Width="9" Height="10"><L>######</L><L>#    ####</L><L># ## .  #</L><L># ###*# #</L><L># # $@# #</L><L># # * # #</L><L>#   *   #</L><L>## # ####</L><L> #   #</L><L> #####</L></Level><Level Id="COSMONOTES 9" Width="9" Height="10"><L>  #######</L><L>  #     #</L><L>### ### #</L><L># $ $ # #</L><L>#...@.# #</L><L># $ $ # #</L><L>### ### #</L><L> #      #</L><L> #   ####</L><L> #####</L></Level><Level Id="COSMONOTES 10" Width="11" Height="10"><L>#### #####</L><L>#  ###   #</L><L>#  $     #</L><L>#  #$##$##</L><L>## #@    #</L><L> # #$# # ##</L><L> # # . .  #</L><L> #    #   #</L><L> #  #. .###</L><L> ########</L></Level><Level Id="COSMONOTES 11" Width="10" Height="7"><L>   #####</L><L>####. .###</L><L># $  #   #</L><L>#@# .$.$ #</L><L># $ # # ##</L><L>###     #</L><L>  #######</L></Level><Level Id="COSMONOTES 12" Width="10" Height="9"><L>  ########</L><L> ##  #   #</L><L>##       #</L><L>#  # .# ##</L><L># $* **$#</L><L>## ##.# #</L><L> # #@   #</L><L> #    ###</L><L> ######</L></Level><Level Id="COSMONOTES 13" Width="8" Height="10"><L> #######</L><L> #  #  #</L><L> #     #</L><L>## ##  #</L><L>#   #.##</L><L>#   *  #</L><L>### *  #</L><L>  #$* ##</L><L>  #@ ##</L><L>  ####</L></Level><Level Id="COSMONOTES 14" Width="9" Height="7"><L>   ####</L><L>####  ##</L><L># $    ##</L><L>#.+***  #</L><L># $     #</L><L>#####  ##</L><L>    ####</L></Level><Level Id="COSMONOTES 15" Width="8" Height="7"><L> #####</L><L> #@. #</L><L>##$.$##</L><L>#  *  ##</L><L>#  .$  #</L><L>####   #</L><L>   #####</L></Level><Level Id="COSMONOTES 16" Width="10" Height="9"><L>  ######</L><L> ##    #</L><L>## @## #</L><L>#  #  $###</L><L>#  ....$ #</L><L>#  # $   #</L><L>######$ ##</L><L>     #  #</L><L>     ####</L></Level><Level Id="COSMONOTES 17" Width="9" Height="8"><L>#########</L><L>#   #   #</L><L># $   $ #</L><L>##$#@#$##</L><L> #. ..  #</L><L> ## .#  #</L><L>  ##   ##</L><L>   #####</L></Level><Level Id="COSMONOTES 18" Width="9" Height="8"><L>  #######</L><L>###     #</L><L>#   ### #</L><L># #$* # #</L><L>#  $. # #</L><L>###$.   #</L><L>  #@. ###</L><L>  #####</L></Level><Level Id="COSMONOTES 19" Width="8" Height="11"><L> ####</L><L> #  ###</L><L>## * @#</L><L>#  *#$##</L><L>#  .   #</L><L>## * # #</L><L> # * # #</L><L> ## #  #</L><L> #    ##</L><L> #   ##</L><L> #####</L></Level><Level Id="COSMONOTES 20" Width="10" Height="9"><L>   ####</L><L>####@ ###</L><L>#  $ $  ##</L><L># #$#$#  #</L><L># # . .  #</L><L># # . . ##</L><L># ## ####</L><L>#    #</L><L>######</L></Level></LevelCollection></SokobanLevels>