<?xml version="1.0" encoding="utf-8"?><!DOCTYPE SokobanLevels SYSTEM "SokobanLev.dtd"[]><SokobanLevels><Title>Microban III</Title><Description></Description><Email>sasquatch@bentonrea.com</Email><LevelCollection Copyright="David W. Skinner" MaxWidth="47" MaxHeight="42"><Level Id="Level 1" Width="8" Height="8"><L>####</L><L>#  #</L><L>#  #</L><L>#  #####</L><L>#.$$ $@#</L><L>#  . . #</L><L>#  #####</L><L>####</L></Level><Level Id="Level 2" Width="7" Height="6"><L>  ####</L><L>###  #</L><L># $.@##</L><L>#  *  #</L><L>#  *  #</L><L>#######</L></Level><Level Id="Level 3" Width="7" Height="8"><L>#######</L><L>#     #</L><L># .$  #</L><L>##.$###</L><L>#  @  #</L><L># .$# #</L><L>#     #</L><L>#######</L></Level><Level Id="Level 4" Width="6" Height="9"><L>######</L><L>#  @ #</L><L># #$ #</L><L># .*.#</L><L>###$ #</L><L>#  * #</L><L>#    #</L><L>###  #</L><L>  ####</L></Level><Level Id="Level 5" Width="10" Height="6"><L>######</L><L>#    #####</L><L>#   $ $  #</L><L>###$...@ #</L><L>  #  #####</L><L>  ####</L></Level><Level Id="Level 6" Width="8" Height="7"><L>########</L><L>#  #  ##</L><L># *#$.##</L><L># * $. #</L><L># @    #</L><L>#   ####</L><L>########</L></Level><Level Id="Level 7" Width="9" Height="9"><L> ####</L><L> #  #####</L><L> #$   $ #</L><L> # .#.  #</L><L>## ### ##</L><L># $.#. #</L><L># @   $#</L><L>#####  #</L><L>    ####</L></Level><Level Id="Level 8" Width="16" Height="8"><L>################</L><L>#  #  #  #  #  #</L><L>#  .  #  #  #  #</L><L># $#  *  #  #  #</L><L>#  #  # @*  #$ #</L><L>#  #  #  #  .  #</L><L>#  #  #  #  #  #</L><L>################</L></Level><Level Id="Level 9" Width="15" Height="8"><L>  ####</L><L> ##  #########</L><L> #           #</L><L> #  ##### ## ##</L><L>### ## # .$.$ #</L><L># $@$  #      #</L><L># . .  ########</L><L>########</L></Level><Level Id="Level 10" Width="9" Height="7"><L>########</L><L>#      #</L><L># $.#..##</L><L>##$.$$@ #</L><L># $.#   #</L><L>#   #####</L><L>#####</L></Level><Level Id="Level 11" Width="13" Height="8"><L>####### #####</L><L>#   ..###   #</L><L>#  ##.#     #</L><L># @##$# $  ##</L><L>#      $ ###</L><L>#  #  #  #</L><L>#######  #</L><L>      ####</L></Level><Level Id="Level 12" Width="8" Height="8"><L>####</L><L>#  ####</L><L>#...  #</L><L>#.##  ##</L><L>#  $ $ #</L><L>###$ $ #</L><L>  #@   #</L><L>  ######</L></Level><Level Id="Level 13" Width="7" Height="8"><L> ####</L><L> #  ###</L><L> # *  #</L><L> # *#@#</L><L>## *  #</L><L>#  .$##</L><L>#    #</L><L>######</L></Level><Level Id="Level 14" Width="8" Height="8"><L>########</L><L>#    @ #</L><L># $  $ #</L><L>## ## ##</L><L># $# $#</L><L>#  .. #</L><L>## .. #</L><L> ######</L></Level><Level Id="Level 15" Width="8" Height="8"><L>####</L><L># @####</L><L>#     ##</L><L># .#.  #</L><L>##$$$$ #</L><L># . .###</L><L>#    #</L><L>######</L></Level><Level Id="Level 16" Width="8" Height="10"><L>   ####</L><L> ###@ #</L><L> #    ##</L><L>##$#.. #</L><L>#  $ # #</L><L># # $  #</L><L># ..#$##</L><L>##    #</L><L> #  ###</L><L> ####</L></Level><Level Id="Level 17" Width="9" Height="8"><L>######</L><L>#   ###</L><L>#   ####</L><L>## $ * ##</L><L>##$#... #</L><L># $   @ #</L><L>#   ##  #</L><L>#########</L></Level><Level Id="Level 18" Width="9" Height="7"><L>########</L><L>#   .  #</L><L># $ #  ##</L><L># ** ** #</L><L>##  # $ #</L><L> #  . @ #</L><L> ########</L></Level><Level Id="Level 19" Width="9" Height="8"><L>######</L><L>#    ##</L><L>#.$$. ##</L><L># .$$. ##</L><L>## .$$. #</L><L> ## .$$.#</L><L>  ## @  #</L><L>   ######</L></Level><Level Id="Level 20" Width="11" Height="9"><L>    ####</L><L> ####  ##</L><L> #  # * ##</L><L>##.$#  * ##</L><L>#   @ * * #</L><L>#   #  *  #</L><L>######    #</L><L>    ###  ##</L><L>      ####</L></Level><Level Id="Level 21" Width="9" Height="10"><L>    #####</L><L>   ##   #</L><L>   #  @ #</L><L>#### # ##</L><L>#. .  . #</L><L>#  ###  #</L><L>## $ $ ##</L><L> #  $ ##</L><L> ###  #</L><L>   ####</L></Level><Level Id="Level 22" Width="11" Height="14"><L>##### #####</L><L>#   ###   #</L><L>#    ##   #</L><L>##    $$ ##</L><L> #  #  $ #</L><L> ###  #  #</L><L>   # @####</L><L>   #    #</L><L> ### ## #</L><L> #    # #</L><L> #.. .# #</L><L> ## ### #</L><L>  #     #</L><L>  #######</L></Level><Level Id="Level 23" Width="15" Height="15"><L>    ####</L><L>    #  ###</L><L>    #  . #</L><L>    #  $ #</L><L>    ## ########</L><L> #####   ##   #</L><L> #  #  *      #</L><L>##.$# *@* #$.##</L><L>#      *  #  #</L><L>#   ##   #####</L><L>######## ##</L><L>     # $  #</L><L>     # .  #</L><L>     ###  #</L><L>       ####</L></Level><Level Id="Level 24" Width="15" Height="15"><L>    ####</L><L>    #  ###</L><L>    #  . #</L><L>    #  $ #</L><L>    ## ########</L><L> #####  ###   #</L><L> #  ## *      #</L><L>##.$# * * #$.##</L><L>#      * ##  #</L><L>#   ###  #####</L><L>######## ##</L><L>     # $  #</L><L>     # .@ #</L><L>     ###  #</L><L>       ####</L></Level><Level Id="Level 25" Width="8" Height="12"><L>#####</L><L>#   ##</L><L># #  #</L><L># #$.###</L><L>#  .$  #</L><L># #$.# #</L><L># #.$# #</L><L>#  $. @#</L><L>###.$# #</L><L>  #  # #</L><L>  ##   #</L><L>   #####</L></Level><Level Id="Level 26" Width="13" Height="11"><L>  #####</L><L>  #   #</L><L>  #.# #######</L><L>  # $       #</L><L>  #.# ### # #</L><L> ##  #   $$ #</L><L> ##.# #   ###</L><L>##      ###</L><L>#  @ ####</L><L>#   ##</L><L>#####</L></Level><Level Id="Level 27" Width="13" Height="10"><L>     ####</L><L>###### .#</L><L>#      .#</L><L>#  #$#@.#####</L><L>## #   . #  #</L><L> #  ###  $$ #</L><L> # #   ##$  #</L><L> #         ##</L><L> #  ########</L><L> ####</L></Level><Level Id="Level 28" Width="10" Height="7"><L>####  ####</L><L>#  ####  #</L><L># $$  $$ #</L><L># .$..$. #</L><L>## .  . ##</L><L> ## @  ##</L><L>  ######</L></Level><Level Id="Level 29" Width="12" Height="8"><L>       #####</L><L> #######   #</L><L>##   ..# $ #</L><L># $ $..# $ #</L><L># $ #..$ $ #</L><L># $ #..   ##</L><L># @ #######</L><L>#####</L></Level><Level Id="Level 30" Width="11" Height="8"><L>###########</L><L>#  *.*.*  #</L><L>#   $+$   #</L><L>### ### ###</L><L>  #  $   #</L><L>  #  #   #</L><L>  #  #####</L><L>  ####</L></Level><Level Id="Level 31" Width="12" Height="11"><L>       ####</L><L>  ###### .#</L><L>###       #</L><L>#  $$ # ..#</L><L># $  #  .##</L><L>#  $$# #.###</L><L>###  #     #</L><L>  #    # # #</L><L>  ##### @  #</L><L>      #   ##</L><L>      #####</L></Level><Level Id="Level 32" Width="16" Height="11"><L>############</L><L>#   .#  #  #</L><L>#   .#    $###</L><L># @#.# $#  $ ##</L><L>#   .   # $   ##</L><L>#  ##### ##    #</L><L>####   ##    # #</L><L>        # #  # #</L><L>        #  ##  #</L><L>        ##    ##</L><L>         ######</L></Level><Level Id="Level 33" Width="19" Height="12"><L>           #######</L><L>          ##     #</L><L>         ##  ### #</L><L>         #  $ $  ##</L><L>         # $ $ $  #</L><L> #########  ###   #</L><L> # . . . # ## #####</L><L>##        @  $ #</L><L>#  . . . # #   #</L><L># ######## #####</L><L>#          #</L><L>############</L></Level><Level Id="Level 34" Width="9" Height="7"><L>  #####</L><L>### @ ###</L><L># $$$$$ #</L><L># ..... #</L><L>#   #   #</L><L>#########</L><L>    #</L></Level><Level Id="Level 35" Width="8" Height="8"><L>####</L><L>#   ###</L><L># .$. #</L><L># $*  #</L><L> #  *$ #</L><L> # .$. #</L><L> ###  @#</L><L>    ####</L></Level><Level Id="Level 36" Width="11" Height="11"><L>###########</L><L>#   #     #</L><L>#  .$ ##  #</L><L># #.$##.. #</L><L># ##   $$##</L><L>#  #   #  #</L><L>##$$   ## #</L><L># ..##$.# #</L><L>#  ## $.  #</L><L>#   @ #   #</L><L>###########</L></Level><Level Id="Level 37" Width="10" Height="8"><L>####</L><L>#  #</L><L>#  #</L><L>#  #######</L><L>#.$$ $ $@#</L><L>#  . . . #</L><L>#  #######</L><L>####</L></Level><Level Id="Level 38" Width="8" Height="10"><L>####</L><L># @#</L><L>#  ###</L><L>#.$$ #</L><L>#  . #</L><L>#  #####</L><L>#.$$ $ #</L><L>#  . . #</L><L>#  #####</L><L>####</L></Level><Level Id="Level 39" Width="10" Height="12"><L>      ####</L><L>     ##  #</L><L>   ### @ #</L><L>   #  $  #</L><L>   #    ##</L><L>  ### ###</L><L>### $$ #</L><L># .....#</L><L>#   $$ #</L><L># # #  #</L><L>#   ####</L><L>#####</L></Level><Level Id="Level 40" Width="11" Height="14"><L>   ########</L><L>   #   #  #</L><L>   #      #</L><L> #####$## #</L><L> #   # ## #</L><L> #   #  #.#</L><L> ##  $  #.#</L><L>  #  #  #.#</L><L>  #$#####.#</L><L>### #  ## #</L><L>#        @#</L><L># $##  #  #</L><L>#      ####</L><L>########</L></Level><Level Id="Level 41" Width="10" Height="11"><L>#########</L><L>#   ##  #</L><L>#@#$    #</L><L>#  $$## ##</L><L>##    # ##</L><L>###$##.  #</L><L>  #  #. .#</L><L>  ##  .###</L><L>   #    #</L><L>   ##   #</L><L>   ######</L></Level><Level Id="Level 42" Width="11" Height="10"><L>#####</L><L>#   #######</L><L>#   ...   #</L><L>## $ $ $  #</L><L>######@####</L><L>#  $ $ $ ##</L><L>#   ...  #</L><L>#######  #</L><L>      #  #</L><L>      ####</L></Level><Level Id="Level 43" Width="11" Height="11"><L>   ####</L><L>   #  #</L><L>   #  ##</L><L>  ##$. ####</L><L>### $.$$  #</L><L>#  ..@..  #</L><L>#  $$.$ ###</L><L>#### .$##</L><L>   ##  #</L><L>    #  #</L><L>    ####</L></Level><Level Id="Level 44" Width="8" Height="9"><L>  ####</L><L>###  ###</L><L>#      #</L><L># $ $ $#</L><L>#*.*.*.#</L><L># $ $ $#</L><L>#*.*.*.#</L><L># @    #</L><L>########</L></Level><Level Id="Level 45" Width="11" Height="12"><L>  ######</L><L>  #  ####</L><L>  # $ $ ##</L><L>### #.#.###</L><L>#     #   #</L><L># # #.#.# #</L><L># # $ $ # #</L><L>#  #  # # #</L><L>##  #   # #</L><L> ##  ###  #</L><L>  ##  @  ##</L><L>   #######</L></Level><Level Id="Level 46" Width="14" Height="14"><L>#####    #####</L><L>#  #######   #</L><L># $ #####  $ #</L><L>#  $ ###  $ ##</L><L>##  $ #  $ ###</L><L> ##  .... ###</L><L> ### .##.####</L><L> ####.##. ###</L><L> ### ....  ##</L><L>### $  # $  ##</L><L>## $  ### $  #</L><L># $  ##### $ #</L><L>#@  #######  #</L><L>#####    #####</L></Level><Level Id="Level 47" Width="15" Height="13"><L>    #######</L><L>  ####   ####</L><L>#### $ # $ ####</L><L>#  #  $ $  #  #</L><L>#      #      #</L><L>#* ######### *#</L><L>#  ....@....  #</L><L>#* ######### *#</L><L>#      #      #</L><L>#  #  $ $  #  #</L><L>#### $ # $ ####</L><L>  ####   ####</L><L>    #######</L></Level><Level Id="Level 48" Width="9" Height="7"><L>########</L><L># @ #  ##</L><L>#  *#$.##</L><L>## * $. #</L><L>##      #</L><L> ###   ##</L><L>  #######</L></Level><Level Id="Level 49" Width="8" Height="8"><L>  ######</L><L>  ##  ##</L><L>###   ##</L><L>#  .*$ #</L><L>#  *.$@#</L><L>##   ###</L><L>##  ##</L><L>######</L></Level><Level Id="Level 50" Width="8" Height="8"><L>  ######</L><L> ###  ##</L><L>###   ##</L><L>#  .*$ #</L><L>#  *.$@#</L><L>##   ###</L><L> ##  # #</L><L>  ######</L></Level><Level Id="Level 51" Width="9" Height="9"><L>    #####</L><L> ####   #</L><L> #   $  #</L><L>##  #$###</L><L># * .  #</L><L>#  * #@#</L><L>### .  #</L><L>  #  ###</L><L>  ####</L></Level><Level Id="Level 52" Width="9" Height="10"><L>    #####</L><L> ####   #</L><L> #   $  #</L><L>##  #$###</L><L># * .  #</L><L>#  * #@#</L><L>##  *  #</L><L> # . ###</L><L> ##  #</L><L>  ####</L></Level><Level Id="Level 53" Width="9" Height="10"><L>    #####</L><L> ####   #</L><L> #   $  #</L><L>##  #$###</L><L># * .  #</L><L>#  * #@#</L><L>##  *  #</L><L> # * .##</L><L> ##   #</L><L>  #####</L></Level><Level Id="Level 54" Width="16" Height="12"><L>####</L><L>#  ######</L><L>#       ####</L><L># $ $   #  #####</L><L>##### ###    $ #</L><L>   #     $ #   #</L><L>   #  @  #$#####</L><L>   ##### #  .#</L><L>      #  ###.#</L><L>      #   ...#</L><L>      #####  #</L><L>          ####</L></Level><Level Id="Level 55" Width="11" Height="11"><L>##### #####</L><L>#   ###   #</L><L># #. #  # #</L><L>#  $.$ $. #</L><L>##  $.$. ##</L><L> ##$.@.$##</L><L>## .$.$  ##</L><L># .$ $.$  #</L><L># #  # .# #</L><L>#   ###   #</L><L>##### #####</L></Level><Level Id="Level 56" Width="11" Height="11"><L>   #####</L><L>   #   #</L><L>  ## .$##</L><L>####$. ####</L><L># $ $.$$  #</L><L># ...@... #</L><L>#  $$.$ $ #</L><L>#### .$####</L><L>  ##$. ##</L><L>   #   #</L><L>   #####</L></Level><Level Id="Level 57" Width="13" Height="13"><L>  #########</L><L>  #       #</L><L>### # # # ###</L><L>#  $.$.$.$  #</L><L># #.$.$.$.# #</L><L>#  $.# #.$  #</L><L># #.$ @ $.# #</L><L>#  $.# #.$  #</L><L># #.$.$.$.# #</L><L>#  $.$.$.$  #</L><L>### # # # ###</L><L>  #       #</L><L>  #########</L></Level><Level Id="Level 58" Width="15" Height="15"><L>###############</L><L>#             #</L><L># # # # # # # #</L><L>#  $.$.$.$.$  #</L><L># #.$.$.$.$.# #</L><L>#  $.$.$.$.$  #</L><L># #.$.$.$.$.# #</L><L>#  $.$.@.$.$  #</L><L># #.$.$.$.$.# #</L><L>#  $.$.$.$.$  #</L><L># #.$.$.$.$.# #</L><L>#  $.$.$.$.$  #</L><L># # # # # # # #</L><L>#             #</L><L>###############</L></Level><Level Id="Level 59" Width="17" Height="11"><L>#################</L><L>#               #</L><L>#.$.$.######### #</L><L>#$.$.$          #</L><L>#.$.$.######### #</L><L>#$.$.$          #</L><L>#.$.$.######### #</L><L>#       $       #</L><L># ############# #</L><L>#       @       #</L><L>#################</L></Level><Level Id="LOMA 1a" Width="8" Height="10"><L>  #####</L><L> ##   ##</L><L>### #  #</L><L>###$.# #</L><L>#  $.#@#</L><L># #$.# #</L><L># #    #</L><L>#  # ###</L><L>##   ##</L><L> #####</L></Level><Level Id="LOMA 1b" Width="8" Height="7"><L>########</L><L>#      #</L><L># #$.@ #</L><L>#  $.###</L><L># #$.#</L><L>#   ##</L><L>#####</L></Level><Level Id="LOMA 1c" Width="9" Height="7"><L> #####</L><L> #   ####</L><L> #  $.  #</L><L> ## $.  #</L><L>  ##$.###</L><L>   #@ #</L><L>   ####</L></Level><Level Id="LOMA 1d" Width="7" Height="8"><L>  ####</L><L>  #  #</L><L>  #  #</L><L>###$.#</L><L>#  $.##</L><L># #$. #</L><L>#   @ #</L><L>#######</L></Level><Level Id="LOMA 1e" Width="10" Height="8"><L>##### ####</L><L>#   ###  #</L><L>#    ##@ #</L><L>##    #$.#</L><L> ##    $.#</L><L># ##  #$.#</L><L>## ## #  #</L><L>### ######</L></Level><Level Id="LOMA 2a" Width="8" Height="8"><L>#####</L><L>#   ####</L><L># #$.  #</L><L>#  .$#@#</L><L>###$.  #</L><L>  #  ###</L><L>  #  #</L><L>  ####</L></Level><Level Id="LOMA 2b" Width="8" Height="9"><L>  ######</L><L>###    #</L><L>#   ## #</L><L># #$.  #</L><L>#@#.$###</L><L># #$.##</L><L>#     #</L><L>###   #</L><L>  #####</L></Level><Level Id="LOMA 2c" Width="8" Height="7"><L>  ######</L><L>###    #</L><L>#  $.# #</L><L>#@#.$  #</L><L># #$.###</L><L>#    #</L><L>######</L></Level><Level Id="LOMA 2d" Width="8" Height="8"><L>   #####</L><L>####   #</L><L>#  $.# #</L><L>#@#.$  #</L><L># #$.###</L><L># #  #</L><L>#    #</L><L>######</L></Level><Level Id="LOMA 3a" Width="7" Height="9"><L>  ####</L><L> ##  #</L><L> # . #</L><L> # * #</L><L>## *###</L><L>#  $ #</L><L>#  @ #</L><L>#  ###</L><L>####</L></Level><Level Id="LOMA 3b" Width="8" Height="9"><L>####</L><L>#  ####</L><L>#     #</L><L>#  .# #</L><L>###*# ##</L><L> #@*   #</L><L> # $   #</L><L> ###  ##</L><L>   ####</L></Level><Level Id="LOMA 3c" Width="6" Height="8"><L> #####</L><L> # . #</L><L> # * #</L><L>## * #</L><L>#  * #</L><L># @$ #</L><L>#  ###</L><L>####</L></Level><Level Id="LOMA 3d" Width="7" Height="10"><L> ######</L><L> # .  #</L><L> # *# #</L><L> #@*  #</L><L> # * ##</L><L> ##$  #</L><L> #    #</L><L> # # ##</L><L> #   #</L><L> #####</L></Level><Level Id="LOMA 4a" Width="8" Height="9"><L>###### #</L><L>#   ## #</L><L>#  . #</L><L>#  $ ###</L><L>## * @ #</L><L>###$ # #</L><L>  #.#  #</L><L># #   ##</L><L># ######</L></Level><Level Id="LOMA 4b" Width="8" Height="9"><L>#####</L><L>#   ##</L><L># #. ###</L><L>#  $ @ #</L><L>###*   #</L><L>#  $ ###</L><L># #.##</L><L>#   #</L><L>#####</L></Level><Level Id="LOMA 4c" Width="6" Height="9"><L>#####</L><L>#   #</L><L># . #</L><L># $ #</L><L>##* ##</L><L># $  #</L><L># . @#</L><L>###  #</L><L>  ####</L></Level><Level Id="LOMA 4d" Width="7" Height="10"><L> ######</L><L> ###  #</L><L> # . @#</L><L> # $  #</L><L>###* ##</L><L>#  $ ##</L><L># #. #</L><L>#   ##</L><L>##  ##</L><L>######</L></Level><Level Id="LOMA 5a" Width="8" Height="10"><L> ####</L><L> #  #</L><L> #  #</L><L> #  ####</L><L>###$$  #</L><L>#  $.  #</L><L># #..###</L><L># @# #</L><L>##   #</L><L>######</L></Level><Level Id="LOMA 5b" Width="8" Height="7"><L>#####</L><L>#  @####</L><L># #$$  #</L><L>#  $.# #</L><L>###..  #</L><L>  ##   #</L><L>   #####</L></Level><Level Id="LOMA 5c" Width="8" Height="7"><L>   ####</L><L>#### @#</L><L>#  $$ ##</L><L># #$.  #</L><L>#  ..# #</L><L>####   #</L><L>   #####</L></Level><Level Id="LOMA 5d" Width="7" Height="9"><L> #####</L><L> #   #</L><L> # # #</L><L> # @ #</L><L>##$$###</L><L># $.  #</L><L># ..# #</L><L>###   #</L><L>  #####</L></Level><Level Id="LOMA 6a" Width="7" Height="8"><L>  #####</L><L>  ##  #</L><L>###   #</L><L>#  $  #</L><L># .*.##</L><L>## $ #</L><L>###@ #</L><L>  ####</L></Level><Level Id="LOMA 6b" Width="6" Height="8"><L>  ####</L><L> ##  #</L><L>###$ #</L><L># .*.#</L><L># #$ #</L><L>#  @ #</L><L>#   ##</L><L>#####</L></Level><Level Id="LOMA 6c" Width="9" Height="9"><L>   #####</L><L>   #   ##</L><L> ### #  #</L><L>##  $ # #</L><L>#  .*.  #</L><L># # $  ##</L><L>#  #@###</L><L>##   #</L><L> #####</L></Level><Level Id="LOMA 6d" Width="9" Height="7"><L>### #####</L><L>#####   #</L><L>### $ # #</L><L># @.*.  #</L><L># # $ ###</L><L>#   #####</L><L>##### ###</L></Level><Level Id="LOMA 7a" Width="8" Height="8"><L>#####</L><L>#   ##</L><L>#  $ ##</L><L>##$*. ##</L><L> # .@  #</L><L> #  #  #</L><L>#####  #</L><L>##  ####</L></Level><Level Id="LOMA 7b" Width="8" Height="8"><L>#####</L><L>#   ####</L><L># #@$  #</L><L>#  $*. #</L><L>####. ##</L><L> #    #</L><L> #   ##</L><L> #####</L></Level><Level Id="LOMA 7c" Width="10" Height="8"><L>  ########</L><L>  #      #</L><L>### #### #</L><L>#  @$  # #</L><L>#  $*. # #</L><L>#  #.### #</L><L>#  #     #</L><L>##########</L></Level><Level Id="LOMA 7d" Width="10" Height="10"><L>  ####</L><L>  #  #####</L><L>  #      #</L><L>### ###  #</L><L># @$  #  #</L><L># $*. # ##</L><L>###.### #</L><L> #      #</L><L> #   #  #</L><L> ########</L></Level><Level Id="LOMA 8a" Width="7" Height="8"><L>  #####</L><L> ##   #</L><L>###   #</L><L>#  * ##</L><L># .@$##</L><L>#  * ##</L><L>##  ##</L><L>#####</L></Level><Level Id="LOMA 8b" Width="7" Height="7"><L> ####</L><L> #  ##</L><L>## * ##</L><L># .@$ #</L><L>#  *  #</L><L>#  #  #</L><L>#######</L></Level><Level Id="LOMA 8c" Width="7" Height="7"><L>  #####</L><L> ##   #</L><L>## *  #</L><L># .@$##</L><L>#  *  #</L><L>###   #</L><L>#######</L></Level><Level Id="LOMA 8d" Width="8" Height="9"><L> #####</L><L> #   ##</L><L>## #  ##</L><L># * #  #</L><L>#.@$ # #</L><L># *  # #</L><L>###    #</L><L>  #  ###</L><L>  ####</L></Level><Level Id="LOMA 9a" Width="8" Height="8"><L>  ####</L><L>  #  #</L><L>###  ###</L><L>## $*  #</L><L>#  *. @#</L><L>#   ####</L><L>#  ##</L><L>#####</L></Level><Level Id="LOMA 9b" Width="9" Height="7"><L>#####</L><L>#   #####</L><L>#   #   #</L><L>## $*@  #</L><L> # *.  ##</L><L> #  ####</L><L> ####</L></Level><Level Id="LOMA 9c" Width="8" Height="8"><L>  ####</L><L>  #@ #</L><L>  #  ##</L><L>###$* ##</L><L>#  *.  #</L><L>#      #</L><L>#####  #</L><L>    ####</L></Level><Level Id="LOMA 9d" Width="9" Height="8"><L>     ####</L><L>######  #</L><L>#  ##   #</L><L>#   $*  #</L><L>#  #*. ##</L><L>##  @ ##</L><L> #  ###</L><L> ####</L></Level><Level Id="LOMA 10a" Width="8" Height="6"><L>#### ###</L><L>#@ ### #</L><L># $$ ###</L><L># $ .  #</L><L>## ..  #</L><L> #######</L></Level><Level Id="LOMA 10b" Width="7" Height="9"><L>####</L><L>#  #</L><L>#@ ###</L><L># $$ ##</L><L># $ . #</L><L>###.. #</L><L> #   ##</L><L> #   #</L><L> #####</L></Level><Level Id="LOMA 10c" Width="7" Height="7"><L>######</L><L>#    #</L><L>#    #</L><L>## $$##</L><L> # $@.#</L><L> ## ..#</L><L>  #####</L></Level><Level Id="LOMA 10d" Width="7" Height="6"><L>  #####</L><L>###   #</L><L># $$# #</L><L># $@. #</L><L>#  .. #</L><L>#######</L></Level><Level Id="Level 101" Width="47" Height="42"><L>     #####     #####     #####     #####</L><L>     #   #######   #######   #######   ####</L><L>     # # #  #### # #  #### # #  #### # #  ##</L><L>     #       ###       ###       ###       ##</L><L>    #### #    #### #    #### #    #### #    ##</L><L>#######   #    ##   #    ##   #    ##   #    #</L><L>#   ###    #    #    #    #    #    #    # $ #</L><L># # #  #    #    #    #    #    #    #    #  #</L><L>#       #    #    #    #    #    #    #    ###</L><L>### #    #    #    #    #    #    #    #    ##</L><L> #   #    #    #    #    #    #    #    #    #</L><L> #    #    #    #    #    #    #    #    #   #</L><L> ##    #    #    #    #    #    #    #    # ###</L><L> ###    #    #    #    #    #    #    #       #</L><L> ####    #    #    #    #    #    #    #  # # #</L><L>######    #    #    #    #    #    #    ###   #</L><L>#   ###    #    #    #    #    #    #    ######</L><L># # #  #    #    #    #    #    #    #    ####</L><L>#       #    #    #    #    #    #    #    ###</L><L>### #    #    #    #    #    #    #    #    ##</L><L> #   #    #    #    #    #    #    #    #    #</L><L> #    #    #    #    #    #    #    #    #   #</L><L> ##    #    #    #    #    #    #    #    # ###</L><L> ###    #    #    #    #    #    #    #       #</L><L> ####    #    #    #    #    #    #    #  # # #</L><L>######    #    #    #    #    #    #    ###   #</L><L>#   ###    #    #    #    #    #    #    ######</L><L># # #  #    #    #    #    #    #    #    ####</L><L>#       #    #    #    #    #    #    #    ###</L><L>### #    #    #    #    #    #    #    #    ##</L><L> #   #    #    #    #    #    #    #    #    #</L><L> #    #    #    #    #    #    #    #    #   #</L><L> ##    #    #    #    #    #    #    #    # ###</L><L> ###    #    #    #    #    #    #    #       #</L><L> #  #    #    #    #    #    #    #    #  # # #</L><L> # . #    #    #    #    #    #    #    ###   #</L><L> #  @ #   ##    #   ##    #   ##    #   #######</L><L> ##    # ####    # ####    # ####    # ####</L><L>  ##       ###       ###       ###       #</L><L>   ##  # # ####  # # ####  # # ####  # # #</L><L>    ####   #######   #######   #######   #</L><L>       #####     #####     #####     #####</L></Level></LevelCollection></SokobanLevels>